#######I#########
#####...#########
#####.###....####
#...#.###.##.####
#.#...###..#.####
#.########.#.##.O
#..........#....#
#################