#######O#
I..#..#.#
##.##.#.#
#.....#.#
#.#####.#
#.......#
#########