#############################
#......#.....#.#............#
#.#.####.#.#.#.#.#.########.#
#.#......#.#.....#.#......#.#
#.################.#.######.#
#.....#............#........#
#.########.##################
#.#......#..................O
#.#.#########################
#...........................I
#.###########################
#...........................#
#############################