####################################################
I.........................................##.......#
#########################.###########.###....#.#.#.#
#...#...................#.......#...#.#.########...#
#.#...#####.#####.##.####.#####...#..............#.#
#.#####...###...#.####........######################
#.......#.....#........######......................#
##########.#########.#.######.####################.#
#..........#.......#.#........#..................#.#
#####.######.#######.################.#.###.####.#.#
#..........#....................#...#.#.#.###.####.#
#.#.########.#####.##############.###.#..........#.#
#.#.#......#.#..####.#..........#.#...#.##.###.#.#.#
#.#.#.####.#.#.##....#.##########.#.###.##.###.#...#
#.#.#.#..#.#.#....####.###.#......#.#...#...##.#####
#.#.#.##.#.#.#.##.#....###.######.#.#.###.#.##.#...#
#.#.#....#.#.#.##.#.##.#............#.....#....#.#.#
#.#.####.#.#.####.#.##.######################.##.#.#
#.#......#.#......#.##........................#..#.#
#.########.########.##############################.#
#.................#................................#
###################O################################
