#############I###############
#.........#...#.............#
#.#######...#...#.###.#.###.#
#.#.....#########.#.#####.#.#
#.#.###.#....#..#.#.......#.#
#.#.#.#.####.####.#.#######.#
#.#.#.#....#....#.#..#....#.#
#.#.#.#######.#####.##.####.#
#.#.#................#.#....#
#.#.################.#.#.####
#.#..........#.....#.#.#.#..O
#.########.#.#####.#.#.####.#
#..........#.......#........#
#############################

