################
#..............#
#.###.####.#.#.#
#.#...##...#.#.#
#.#.####.###.###
#.#......#.....#
#.########.###.#
#..........#.#.O
#.########.#.###
#........#.....I
################
