#O###########################
#...........................#
#...........................#
#############################
I...........................#
#.........###############...#
#.........#.............#...#
#.........#.............#...#
#.........#.............#...#
#.........#.............#...#
#.........###########.###...#
#...........................#
#############################
