#############I###############
#...........................#
#...........................#
#...........................#
#...........................#
#...........................#
#...........................#
#...........................#
#...........................#
#...........................#
#...........................O
#...........................#
#...........................#
#############################

