#############I###############
#...........................#
#...........................#
#...........................#
#...........................#
#..........##############...#
#..........##############...#
#..........##############...#
#...........................#
#...###########.............#
#...###########.............#
#...........................#
#...........................#
#############O###############