#############################
#.............#.............#
#.............#.###########.#
#.............#.#.........#.#
#...#######...#.#########.#.#
I...#.....#...............#.#
#...#.....#...#############.#
#...#.....#...#.............#
#...#.....#...#.............#
#...#.....#...#.............#
#...##.#.##...#.............O
#......#......#.............#
#......#....................#
#############################
